;name = Hall
;width = 36
;height = 11
;# = hall-wall
;+ = hall-fence
####################################
#..................................#
#..............+++......#..........#
#..............+.+.....###.......###
####.#.......+++.+++....#......#####
#@...........+.....+...............#
####.#.......+++.+++....#......#####
#..............+.+.....###.......###
#..............+++......#..........#
#..................................#
####################################